batter,player_name,total_pa,uab,cab,uab_rate,cab_rate,PCA+
650333,luis arráez,608,96,512,15.79,84.21,215.3
608070,josé ramírez,664,112,552,16.87,83.13,199.0
660670,ronald acuña,734,129,605,17.57,82.43,189.4
605141,mookie betts,688,122,566,17.73,82.27,187.3
592450,aaron judge,447,84,363,18.79,81.21,174.5
665742,juan soto,698,133,565,19.05,80.95,171.5
608369,corey seager,546,113,433,20.7,79.3,154.7
608324,alex bregman,728,152,576,20.88,79.12,153.0
605170,víctor caratini,227,49,178,21.59,78.41,146.7
650402,gleyber torres,668,145,523,21.71,78.29,145.6
663656,kyle tucker,672,146,526,21.73,78.27,145.5
670541,yordan álvarez,497,108,389,21.73,78.27,145.4
518692,freddie freeman,723,159,564,21.99,78.01,143.2
457705,andrew mccutchen,468,103,365,22.01,77.99,143.1
680757,steven kwan,707,156,551,22.07,77.93,142.6
665489,vladimir guerrero,679,151,528,22.24,77.76,141.2
676475,alec burleson,347,78,269,22.48,77.52,139.2
607043,brandon nimmo,675,152,523,22.52,77.48,138.9
650490,yandy díaz,606,137,469,22.61,77.39,138.2
502054,tommy pham,495,113,382,22.83,77.17,136.5
664774,lamonte wade,512,117,395,22.85,77.15,136.3
657757,gavin sheets,338,78,260,23.08,76.92,134.6
621493,taylor ward,407,94,313,23.1,76.9,134.4
663586,austin riley,717,166,551,23.15,76.85,134.0
663697,jonathan india,526,122,404,23.19,76.81,133.7
657077,alex verdugo,596,139,457,23.32,76.68,132.8
669242,tommy edman,523,122,401,23.33,76.67,132.7
545121,ildemaro vargas,287,67,220,23.34,76.66,132.6
663611,nick madrigal,294,69,225,23.47,76.53,131.7
663647,ke'bryan hayes,521,123,398,23.61,76.39,130.7
668939,adley rutschman,691,164,527,23.73,76.27,129.7
666185,dylan carlson,257,61,196,23.74,76.26,129.7
668804,bryan reynolds,633,151,482,23.85,76.15,128.9
621566,matt olson,718,172,546,23.96,76.04,128.2
592885,christian yelich,634,152,482,23.97,76.03,128.0
500743,miguel rojas,421,101,320,23.99,76.01,127.9
686469,vinnie pasquantino,254,61,193,24.02,75.98,127.8
670623,isaac paredes,579,139,440,24.01,75.99,127.8
543760,marcus semien,773,186,587,24.06,75.94,127.4
547180,bryce harper,555,134,421,24.14,75.86,126.9
596019,francisco lindor,677,164,513,24.22,75.78,126.3
673548,seiya suzuki,585,142,443,24.27,75.73,126.0
643393,tony kemp,416,101,315,24.28,75.72,125.9
457759,justin turner,621,151,470,24.32,75.68,125.7
502671,paul goldschmidt,678,165,513,24.34,75.66,125.5
807799,masataka yoshida,576,141,435,24.48,75.52,124.6
681082,bryson stott,652,160,492,24.54,75.46,124.2
656582,connor joe,472,116,356,24.58,75.42,123.9
646240,rafael devers,643,158,485,24.57,75.43,123.9
592192,mark canha,509,126,383,24.75,75.25,122.7
643217,andrew benintendi,609,151,458,24.79,75.21,122.5
669257,will smith,551,137,414,24.86,75.14,122.0
624424,michael conforto,462,115,347,24.89,75.11,121.8
493329,yuli gurriel,325,81,244,24.92,75.08,121.6
682998,corbin carroll,662,165,497,24.92,75.08,121.6
608671,travis jankowski,288,72,216,25.0,75.0,121.1
606466,ketel marte,660,165,495,25.0,75.0,121.1
519203,anthony rizzo,416,104,312,25.0,75.0,121.1
621043,carlos correa,595,149,446,25.04,74.96,120.9
660271,shohei ohtani,579,145,434,25.04,74.96,120.9
663993,nathaniel lowe,741,186,555,25.1,74.9,120.5
650859,luis rengifo,442,111,331,25.11,74.89,120.4
656811,ryan o'hearn,374,94,280,25.13,74.87,120.3
624428,adam frazier,457,115,342,25.16,74.84,120.1
592626,joc pederson,416,105,311,25.24,74.76,119.6
663457,lars nootbaar,499,126,373,25.25,74.75,119.5
680977,brendan donovan,364,92,272,25.27,74.73,119.4
641355,cody bellinger,550,139,411,25.27,74.73,119.4
664761,alec bohm,625,158,467,25.28,74.72,119.3
545341,randal grichuk,470,119,351,25.32,74.68,119.1
456781,donovan solano,458,116,342,25.33,74.67,119.0
593428,xander bogaerts,658,167,491,25.38,74.62,118.7
593871,jorge polanco,366,93,273,25.41,74.59,118.5
592518,manny machado,594,151,443,25.42,74.58,118.5
664023,ian happ,687,175,512,25.47,74.53,118.1
677551,wander franco,486,124,362,25.51,74.49,117.9
672386,alejandro kirk,426,109,317,25.59,74.41,117.4
571970,max muncy,574,147,427,25.61,74.39,117.3
596129,dan vogelbach,316,81,235,25.63,74.37,117.1
660688,keibert ruiz,557,143,414,25.67,74.33,116.9
669004,mj melendez,597,154,443,25.8,74.2,116.2
666023,freddy fermin,236,61,175,25.85,74.15,115.8
518595,travis d'arnaud,290,75,215,25.86,74.14,115.7
672779,tucupita marcano,220,57,163,25.91,74.09,115.5
666182,bo bichette,606,157,449,25.91,74.09,115.5
655316,andruw monasterio,316,82,234,25.95,74.05,115.2
656896,emmanuel rivera,285,74,211,25.96,74.04,115.1
677594,julio rodríguez,701,182,519,25.96,74.04,115.1
676801,chas mccormick,465,121,344,26.02,73.98,114.8
596146,max kepler,507,132,375,26.04,73.96,114.7
676116,ryan noda,495,129,366,26.06,73.94,114.6
573262,mike yastrzemski,376,98,278,26.06,73.94,114.5
607208,trea turner,706,184,522,26.06,73.94,114.5
542303,marcell ozuna,594,155,439,26.09,73.91,114.4
671277,luis garcía,479,125,354,26.1,73.9,114.3
669743,alex call,436,114,322,26.15,73.85,114.0
467793,carlos santana,627,164,463,26.16,73.84,114.0
668715,spencer steer,663,174,489,26.24,73.76,113.5
671739,michael harris,540,142,398,26.3,73.7,113.2
595281,kevin kiermaier,410,108,302,26.34,73.66,112.9
595777,jurickson profar,523,138,385,26.39,73.61,112.6
641943,joshua palacios,265,70,195,26.42,73.58,112.5
668227,randy arozarena,658,174,484,26.44,73.56,112.3
666397,edouard julien,427,113,314,26.46,73.54,112.2
575929,willson contreras,491,130,361,26.48,73.52,112.1
672580,maikel garcía,517,137,380,26.5,73.5,112.0
596103,austin slater,207,55,152,26.57,73.43,111.6
683734,andrew vaughn,611,163,448,26.68,73.32,111.0
680779,henry davis,254,68,186,26.77,73.23,110.4
656305,matt chapman,586,157,429,26.79,73.21,110.3
683002,gunnar henderson,630,169,461,26.83,73.17,110.1
623993,anthony santander,662,178,484,26.89,73.11,109.8
665487,fernando tatís,636,171,465,26.89,73.11,109.8
650391,eloy jiménez,479,129,350,26.93,73.07,109.6
572233,christian walker,675,182,493,26.96,73.04,109.4
677951,bobby witt,689,186,503,27.0,73.0,109.2
641487,j. p. crawford,632,171,461,27.06,72.94,108.9
670032,nicky lopez,262,71,191,27.1,72.9,108.6
663616,trevor larnach,206,56,150,27.18,72.82,108.2
645277,ozzie albies,666,181,485,27.18,72.82,108.2
663538,nico hoerner,684,186,498,27.19,72.81,108.1
514888,josé altuve,423,115,308,27.19,72.81,108.1
663837,matt vierling,526,143,383,27.19,72.81,108.1
664040,brandon lowe,434,118,316,27.19,72.81,108.1
671213,triston casas,496,135,361,27.22,72.78,108.0
665750,leody taveras,577,157,420,27.21,72.79,108.0
621020,dansby swanson,635,173,462,27.24,72.76,107.8
673490,ha-seong kim,620,169,451,27.26,72.74,107.8
682641,luis matos,253,69,184,27.27,72.73,107.7
669221,sean murphy,436,119,317,27.29,72.71,107.6
643565,mike tauchman,402,110,292,27.36,72.64,107.2
650559,bryan de la cruz,631,173,458,27.42,72.58,106.9
518735,yasmani grandal,397,109,288,27.46,72.54,106.7
661388,william contreras,615,169,446,27.48,72.52,106.6
667670,brent rooker,524,144,380,27.48,72.52,106.6
453568,charlie blackmon,404,111,293,27.48,72.52,106.6
527038,wilmer flores,450,124,326,27.56,72.44,106.2
643396,isiah kiner-falefa,363,100,263,27.55,72.45,106.2
647304,josh naylor,482,133,349,27.59,72.41,106.0
672515,gabriel moreno,388,107,281,27.58,72.42,106.0
656941,kyle schwarber,732,202,530,27.6,72.4,105.9
596142,gary sánchez,268,74,194,27.61,72.39,105.9
622110,matt duffy,210,58,152,27.62,72.38,105.8
664728,kyle isbel,311,86,225,27.65,72.35,105.6
668942,josh rojas,350,97,253,27.71,72.29,105.3
666969,adolis garcía,652,181,471,27.76,72.24,105.1
680869,zack gelof,299,83,216,27.76,72.24,105.1
687952,christian encarnacion-strand,241,67,174,27.8,72.2,104.9
608701,rob refsnyder,244,68,176,27.87,72.13,104.5
605137,josh bell,617,172,445,27.88,72.12,104.5
641598,mitch garver,355,99,256,27.89,72.11,104.4
665161,jeremy peña,640,179,461,27.97,72.03,104.0
624585,jorge soler,579,162,417,27.98,72.02,103.9
545361,mike trout,357,100,257,28.01,71.99,103.8
656976,pavin smith,228,64,164,28.07,71.93,103.5
668670,jake rogers,367,103,264,28.07,71.93,103.5
621550,patrick wisdom,299,84,215,28.09,71.91,103.3
570482,gio urshela,224,63,161,28.12,71.88,103.2
680574,matt mclain,405,114,291,28.15,71.85,103.1
518934,dj lemahieu,561,158,403,28.16,71.84,103.0
666135,alex kirilloff,330,93,237,28.18,71.82,102.9
670770,tj friedl,550,155,395,28.18,71.82,102.9
663886,tyler stephenson,514,145,369,28.21,71.79,102.8
622534,manuel margot,340,96,244,28.24,71.76,102.6
571448,nolan arenado,605,171,434,28.26,71.74,102.5
677950,alek thomas,417,118,299,28.3,71.7,102.3
672695,geraldo perdomo,508,144,364,28.35,71.65,102.1
641680,jonah heim,518,147,371,28.38,71.62,101.9
656775,cedric mullins,461,131,330,28.42,71.58,101.7
680911,owen miller,313,89,224,28.43,71.57,101.6
444482,david peralta,418,119,299,28.47,71.53,101.5
666971,lourdes gurriel,601,171,430,28.45,71.55,101.5
663757,trent grisham,548,156,392,28.47,71.53,101.5
668904,royce lewis,262,75,187,28.63,71.37,100.7
669016,brandon marsh,475,136,339,28.63,71.37,100.6
518792,jason heyward,383,110,273,28.72,71.28,100.2
642086,dominic smith,581,167,414,28.74,71.26,100.1
682848,endy rodríguez,205,59,146,28.78,71.22,99.9
606115,orlando arcia,535,154,381,28.79,71.21,99.9
446334,evan longoria,250,72,178,28.8,71.2,99.8
682626,francisco álvarez,423,122,301,28.84,71.16,99.6
593160,whit merrifield,588,170,418,28.91,71.09,99.3
686823,will brennan,453,131,322,28.92,71.08,99.2
663624,ryan mountcastle,477,138,339,28.93,71.07,99.2
643289,mauricio dubón,494,143,351,28.95,71.05,99.1
607732,jacob stallings,276,80,196,28.99,71.01,98.9
669701,josh smith,231,67,164,29.0,71.0,98.8
605204,j. d. davis,548,159,389,29.01,70.99,98.8
623912,harold ramírez,441,128,313,29.02,70.98,98.7
621563,joey wendle,317,92,225,29.02,70.98,98.7
683146,brett baty,389,113,276,29.05,70.95,98.6
678225,ji hwan bae,368,107,261,29.08,70.92,98.5
543305,aaron hicks,323,94,229,29.1,70.9,98.4
665862,jazz chisholm,384,112,272,29.17,70.83,98.1
642133,rowdy tellez,346,101,245,29.19,70.81,97.9
502110,j. d. martinez,479,140,339,29.23,70.77,97.8
679529,spencer torkelson,681,199,482,29.22,70.78,97.8
621028,kevin newman,253,74,179,29.25,70.75,97.7
682928,cj abrams,612,179,433,29.25,70.75,97.7
543228,yan gomes,417,122,295,29.26,70.74,97.6
592663,j. t. realmuto,550,161,389,29.27,70.73,97.6
668709,jj bleday,304,89,215,29.28,70.72,97.5
673237,yainer diaz,379,111,268,29.29,70.71,97.5
600869,jeimer candelario,572,168,404,29.37,70.63,97.1
553993,eugenio suárez,688,202,486,29.36,70.64,97.1
658668,edward olivares,381,112,269,29.4,70.6,97.0
669357,nolan gorman,459,135,324,29.41,70.59,96.9
642708,amed rosario,537,158,379,29.42,70.58,96.9
571745,mitch haniger,231,68,163,29.44,70.56,96.8
664034,ty france,658,194,464,29.48,70.52,96.6
547989,josé abreu,600,177,423,29.5,70.5,96.5
641584,jake fraley,373,110,263,29.49,70.51,96.5
628451,andy ibáñez,383,113,270,29.5,70.5,96.5
592178,kris bryant,325,96,229,29.54,70.46,96.3
649557,aledmys díaz,338,100,238,29.59,70.41,96.1
657656,ramón laureano,402,119,283,29.6,70.4,96.0
641658,garrett hampson,253,75,178,29.64,70.36,95.8
602104,ramón urías,394,117,277,29.7,70.3,95.6
686681,michael massey,458,136,322,29.69,70.31,95.6
683011,anthony volpe,598,178,420,29.77,70.23,95.3
656716,zach mckinstry,520,155,365,29.81,70.19,95.1
669289,santiago espinal,255,76,179,29.8,70.2,95.1
666181,will benson,325,97,228,29.85,70.15,94.9
543807,george springer,685,205,480,29.93,70.07,94.5
543063,brandon crawford,317,95,222,29.97,70.03,94.4
676059,jordan westburg,237,71,166,29.96,70.04,94.4
592273,brandon drury,520,156,364,30.0,70.0,94.2
643376,danny jansen,300,90,210,30.0,70.0,94.2
608841,joey meneses,656,197,459,30.03,69.97,94.1
408234,miguel cabrera,366,110,256,30.05,69.95,94.0
624415,cavan biggio,346,104,242,30.06,69.94,94.0
664983,jake mccarthy,306,92,214,30.07,69.93,93.9
643446,jeff mcneil,640,193,447,30.16,69.84,93.5
672284,jarred kelenic,407,123,284,30.22,69.78,93.2
668800,andrew knizner,241,73,168,30.29,69.71,92.9
669397,nick allen,330,100,230,30.3,69.7,92.9
672275,patrick bailey,353,107,246,30.31,69.69,92.8
686894,joey wiemer,412,125,287,30.34,69.66,92.7
669720,austin hays,573,174,399,30.37,69.63,92.6
607054,jace peterson,428,130,298,30.37,69.63,92.6
668930,brice turang,451,137,314,30.38,69.62,92.5
676701,alan trejo,227,69,158,30.4,69.6,92.5
666310,bo naylor,230,70,160,30.43,69.57,92.3
669394,jake burger,548,167,381,30.47,69.53,92.1
572761,matt carpenter,233,71,162,30.47,69.53,92.1
669127,shea langeliers,485,148,337,30.52,69.48,91.9
543510,james mccann,226,69,157,30.53,69.47,91.9
516782,starling marte,331,101,230,30.51,69.49,91.9
519317,giancarlo stanton,409,125,284,30.56,69.44,91.7
571771,enrique hernández,510,156,354,30.59,69.41,91.6
664056,harrison bader,346,106,240,30.64,69.36,91.4
680776,jarren duran,362,111,251,30.66,69.34,91.3
665926,andrés giménez,606,186,420,30.69,69.31,91.2
669261,jack suwinski,531,163,368,30.7,69.3,91.2
630105,jake cronenworth,515,158,357,30.68,69.32,91.2
543939,kolten wong,244,75,169,30.74,69.26,91.0
664702,myles straw,510,157,353,30.78,69.22,90.8
641820,trey mancini,260,80,180,30.77,69.23,90.8
657041,lane thomas,679,209,470,30.78,69.22,90.8
516416,jean segura,318,98,220,30.82,69.18,90.6
678246,miguel vargas,295,91,204,30.85,69.15,90.5
687263,zach neto,330,102,228,30.91,69.09,90.3
666624,christopher morel,430,133,297,30.93,69.07,90.2
521692,salvador pérez,575,178,397,30.96,69.04,90.1
622761,jorge mateo,352,109,243,30.97,69.03,90.0
605131,austin barnes,200,62,138,31.0,69.0,89.9
691023,jordan walker,461,143,318,31.02,68.98,89.8
641857,ryan mcmahon,617,192,425,31.12,68.88,89.4
680777,ryan jeffers,356,111,245,31.18,68.82,89.1
681481,kerry carpenter,458,143,315,31.22,68.78,88.9
624413,pete alonso,647,202,445,31.22,68.78,88.9
571657,kyle farmer,371,116,255,31.27,68.73,88.8
595879,javier báez,544,170,374,31.25,68.75,88.8
542932,jon berti,428,134,294,31.31,68.69,88.6
670764,taylor walls,354,111,243,31.36,68.64,88.4
458015,joey votto,242,76,166,31.4,68.6,88.2
641933,tyler o'neill,261,82,179,31.42,68.58,88.1
677649,ezequiel duran,439,138,301,31.44,68.56,88.1
669222,nick senzel,331,104,227,31.42,68.58,88.1
595978,austin hedges,210,66,144,31.43,68.57,88.1
543309,kyle higashioka,261,82,179,31.42,68.58,88.1
670242,matt wallner,267,84,183,31.46,68.54,88.0
543257,robbie grossman,432,136,296,31.48,68.52,87.9
605119,brian anderson,359,113,246,31.48,68.52,87.9
666134,nolan jones,422,133,289,31.52,68.48,87.7
682829,elly de la cruz,428,135,293,31.54,68.46,87.6
594807,adam duvall,348,110,238,31.61,68.39,87.4
667452,corey julks,322,102,220,31.68,68.32,87.1
663743,nick fortes,324,103,221,31.79,68.21,86.6
681546,james outman,566,180,386,31.8,68.2,86.6
642731,thairo estrada,525,167,358,31.81,68.19,86.6
666139,josh lowe,506,161,345,31.82,68.18,86.5
645801,mike ford,251,80,171,31.87,68.13,86.3
660821,jesús sánchez,407,130,277,31.94,68.06,86.0
500871,eduardo escobar,303,97,206,32.01,67.99,85.7
668731,akil baddoo,356,114,242,32.02,67.98,85.7
664913,seth brown,374,120,254,32.09,67.91,85.5
669477,casey schmitt,277,89,188,32.13,67.87,85.3
592669,hunter renfroe,544,175,369,32.17,67.83,85.1
621439,byron buxton,341,110,231,32.26,67.74,84.8
662139,daulton varsho,583,188,395,32.25,67.75,84.8
621438,tyrone taylor,251,81,170,32.27,67.73,84.7
660162,yoán moncada,350,113,237,32.29,67.71,84.7
673962,josh jung,533,172,361,32.27,67.73,84.7
462101,elvis andrus,400,130,270,32.5,67.5,83.9
592206,nick castellanos,686,223,463,32.51,67.49,83.8
669707,jared triolo,209,68,141,32.54,67.46,83.7
670097,zack short,254,83,171,32.68,67.32,83.2
642136,matt thaiss,306,100,206,32.68,67.32,83.2
607680,kevin pillar,208,68,140,32.69,67.31,83.1
678894,liover peguero,213,70,143,32.86,67.14,82.5
666160,mickey moniak,322,106,216,32.92,67.08,82.3
608336,joey gallo,331,109,222,32.93,67.07,82.2
606192,teoscar hernández,671,221,450,32.94,67.06,82.2
665828,oswaldo cabrera,327,108,219,33.03,66.97,81.9
553869,elías díaz,517,171,346,33.08,66.92,81.7
641313,tim anderson,516,171,345,33.14,66.86,81.5
592696,eddie rosario,519,173,346,33.33,66.67,80.8
474832,brandon belt,408,136,272,33.33,66.67,80.8
572191,michael taylor,396,132,264,33.33,66.67,80.8
621035,chris taylor,389,130,259,33.42,66.58,80.4
641343,jake bauers,272,91,181,33.46,66.54,80.3
682985,riley greene,412,138,274,33.5,66.5,80.2
624414,christian arroyo,203,68,135,33.5,66.5,80.2
670042,luke raley,406,136,270,33.5,66.5,80.2
595909,jake cave,200,67,133,33.5,66.5,80.2
642715,willy adames,643,216,427,33.59,66.41,79.8
605113,nick ahmed,205,69,136,33.66,66.34,79.6
665155,nick maton,293,99,194,33.79,66.21,79.1
663728,cal raleigh,562,190,372,33.81,66.19,79.1
543877,christian vázquez,350,119,231,34.0,66.0,78.4
686217,sal frelick,232,79,153,34.05,65.95,78.2
656448,stone garrett,272,93,179,34.19,65.81,77.7
676609,josé caballero,280,96,184,34.29,65.71,77.4
672478,jordan diaz,294,102,192,34.69,65.31,76.0
672356,gabriel arias,345,120,225,34.78,65.22,75.7
650489,willi castro,422,147,275,34.83,65.17,75.5
656413,stuart fairchild,257,90,167,35.02,64.98,74.9
606992,eric haase,288,101,187,35.07,64.93,74.8
666165,blake sabol,342,120,222,35.09,64.91,74.7
643265,garrett cooper,450,158,292,35.11,64.89,74.6
673357,luis robert,582,205,377,35.22,64.78,74.3
605612,harold castro,264,93,171,35.23,64.77,74.2
693049,oscar colás,256,91,165,35.55,64.45,73.2
543068,c. j. cron,270,96,174,35.56,64.44,73.2
665923,esteury ruiz,493,176,317,35.7,64.3,72.7
660707,elehuris montero,298,107,191,35.91,64.09,72.1
657557,paul dejong,401,144,257,35.91,64.09,72.1
676694,jake meyers,335,121,214,36.12,63.88,71.4
686668,brenton doyle,431,157,274,36.43,63.57,70.5
519058,mike moustakas,387,141,246,36.43,63.57,70.4
668901,mark vientos,233,85,148,36.48,63.52,70.3
624512,reese mcguire,205,75,130,36.59,63.41,70.0
666801,rodolfo castro,257,94,163,36.58,63.42,70.0
671221,drew waters,337,125,212,37.09,62.91,68.5
624641,edmundo sosa,300,112,188,37.33,62.67,67.8
455117,martín maldonado,411,154,257,37.47,62.53,67.4
542194,christian bethancourt,330,124,206,37.58,62.42,67.1
657136,connor wong,403,153,250,37.97,62.03,66.0
678662,ezequiel tovar,607,231,376,38.06,61.94,65.7
642350,josé siri,364,142,222,39.01,60.99,63.1
668472,nick pratto,346,141,205,40.75,59.25,58.7
