batter,player_name,total_pa,uab,cab,uab_rate,cab_rate,PCA+
669257,will smith,418,80,338,19.14,80.86,160.2
606466,ketel marte,519,100,419,19.27,80.73,158.9
608070,josé ramírez,625,121,504,19.36,80.64,158.0
665489,vladimir guerrero,635,123,512,19.37,80.63,157.9
650333,luis arráez,647,126,521,19.47,80.53,156.8
605141,mookie betts,637,127,510,19.94,80.06,152.3
672580,maikel garcía,636,127,509,19.97,80.03,152.0
668939,adley rutschman,335,67,268,20.0,80.0,151.7
671289,tyler freeman,426,86,340,20.19,79.81,149.9
608701,rob refsnyder,202,41,161,20.3,79.7,148.9
665487,fernando tatís,656,135,521,20.58,79.42,146.3
677951,bobby witt,641,132,509,20.59,79.41,146.2
650490,yandy díaz,621,128,493,20.61,79.39,146.1
700250,ben rice,512,107,405,20.9,79.1,143.5
665742,juan soto,670,141,529,21.04,78.96,142.3
686948,drake baldwin,420,89,331,21.19,78.81,141.0
608324,alex bregman,462,98,364,21.21,78.79,140.9
663538,nico hoerner,614,131,483,21.34,78.66,139.8
650402,gleyber torres,607,131,476,21.58,78.42,137.8
657077,alex verdugo,213,46,167,21.6,78.4,137.7
676475,alec burleson,528,115,413,21.78,78.22,136.2
680474,max schuemann,202,44,158,21.78,78.22,136.2
595777,jurickson profar,344,75,269,21.8,78.2,136.0
672386,alejandro kirk,477,104,373,21.8,78.2,136.0
573262,mike yastrzemski,526,115,411,21.86,78.14,135.5
641343,jake bauers,205,45,160,21.95,78.05,134.8
656305,matt chapman,507,112,395,22.09,77.91,133.7
543760,marcus semien,515,114,401,22.14,77.86,133.4
686469,vinnie pasquantino,646,143,503,22.14,77.86,133.4
596019,francisco lindor,699,155,544,22.17,77.83,133.1
670623,isaac paredes,414,92,322,22.22,77.78,132.7
592450,aaron judge,620,139,481,22.42,77.58,131.2
663757,trent grisham,560,126,434,22.5,77.5,130.6
680977,brendan donovan,497,112,385,22.54,77.46,130.4
593871,jorge polanco,501,113,388,22.55,77.45,130.2
671056,iván herrera,430,97,333,22.56,77.44,130.2
605137,josh bell,509,115,394,22.59,77.41,129.9
668930,brice turang,628,142,486,22.61,77.39,129.8
607043,brandon nimmo,618,140,478,22.65,77.35,129.5
593428,xander bogaerts,531,121,410,22.79,77.21,128.5
624413,pete alonso,672,154,518,22.92,77.08,127.6
547180,bryce harper,541,124,417,22.92,77.08,127.5
683734,andrew vaughn,421,97,324,23.04,76.96,126.7
680757,steven kwan,660,152,508,23.03,76.97,126.7
805367,chase meidroth,486,112,374,23.05,76.95,126.6
502671,paul goldschmidt,507,117,390,23.08,76.92,126.4
669743,alex call,320,74,246,23.12,76.88,126.1
592626,joc pederson,281,65,216,23.13,76.87,126.0
663457,lars nootbaar,553,129,424,23.33,76.67,124.6
686527,dominic canzone,257,60,197,23.35,76.65,124.5
681082,bryson stott,534,125,409,23.41,76.59,124.1
701350,roman anthony,303,71,232,23.43,76.57,123.9
666182,bo bichette,606,142,464,23.43,76.57,123.9
676391,ernie clement,563,132,431,23.45,76.55,123.8
607208,trea turner,633,149,484,23.54,76.46,123.2
661388,william contreras,637,150,487,23.55,76.45,123.1
666018,jonathan aranda,395,93,302,23.54,76.46,123.1
621043,carlos correa,567,134,433,23.63,76.37,122.5
808982,jung hoo lee,590,140,450,23.73,76.27,121.9
656555,rhys hoskins,316,75,241,23.73,76.27,121.9
686797,brooks lee,513,122,391,23.78,76.22,121.5
695734,daylen lile,340,81,259,23.82,76.18,121.3
660271,shohei ohtani,671,160,511,23.85,76.15,121.1
592518,manny machado,649,155,494,23.88,76.12,120.9
668227,randy arozarena,673,161,512,23.92,76.08,120.6
672515,gabriel moreno,284,68,216,23.94,76.06,120.5
681715,heriberto hernandez,284,68,216,23.94,76.06,120.5
694671,wyatt langford,551,132,419,23.96,76.04,120.4
641355,cody bellinger,626,150,476,23.96,76.04,120.3
694384,nolan schanuel,538,129,409,23.98,76.02,120.2
663656,kyle tucker,545,131,414,24.04,75.96,119.8
664702,myles straw,290,70,220,24.14,75.86,119.2
672695,geraldo perdomo,688,166,522,24.13,75.87,119.2
807712,luke keaschall,207,50,157,24.15,75.85,119.1
671277,luis garcía,505,122,383,24.16,75.84,119.0
656941,kyle schwarber,686,166,520,24.2,75.8,118.8
646240,rafael devers,688,167,521,24.27,75.73,118.3
696285,jacob young,346,84,262,24.28,75.72,118.3
656811,ryan o'hearn,514,125,389,24.32,75.68,118.0
578428,jose iglesias,333,81,252,24.32,75.68,118.0
647304,josh naylor,578,141,437,24.39,75.61,117.5
621566,matt olson,691,169,522,24.46,75.54,117.1
683002,gunnar henderson,629,154,475,24.48,75.52,117.0
682626,francisco álvarez,265,65,200,24.53,75.47,116.7
676914,davis schneider,216,53,163,24.54,75.46,116.6
571970,max muncy,362,89,273,24.59,75.41,116.3
605170,víctor caratini,369,91,278,24.66,75.34,115.8
663616,trevor larnach,546,135,411,24.73,75.27,115.5
676694,jake meyers,372,92,280,24.73,75.27,115.4
502054,tommy pham,416,103,313,24.76,75.24,115.2
664761,alec bohm,468,116,352,24.79,75.21,115.1
681481,kerry carpenter,444,110,334,24.77,75.23,115.1
663697,jonathan india,544,135,409,24.82,75.18,114.9
676572,eric wagaman,494,123,371,24.9,75.1,114.4
543807,george springer,550,137,413,24.91,75.09,114.3
689414,liam hicks,373,93,280,24.93,75.07,114.2
571448,nolan arenado,409,102,307,24.94,75.06,114.1
664770,nathan lukes,415,104,311,25.06,74.94,113.4
683737,michael busch,550,138,412,25.09,74.91,113.2
645277,ozzie albies,647,163,484,25.19,74.81,112.6
665862,jazz chisholm,508,128,380,25.2,74.8,112.6
666023,freddy fermin,333,84,249,25.23,74.77,112.4
669701,josh smith,554,140,414,25.27,74.73,112.1
642715,willy adames,656,166,490,25.3,74.7,111.9
666310,bo naylor,391,99,292,25.32,74.68,111.8
457705,andrew mccutchen,525,133,392,25.33,74.67,111.8
686555,isaac collins,430,109,321,25.35,74.65,111.7
621439,byron buxton,511,130,381,25.44,74.56,111.1
691406,junior caminero,621,158,463,25.44,74.56,111.1
669289,santiago espinal,322,82,240,25.47,74.53,111.0
663968,jake mangum,404,103,301,25.5,74.5,110.8
643446,jeff mcneil,447,114,333,25.5,74.5,110.8
691594,javier sanoja,329,84,245,25.53,74.47,110.6
663728,cal raleigh,656,168,488,25.61,74.39,110.2
671218,heliot ramos,664,170,494,25.6,74.4,110.2
693304,nick gonzales,390,100,290,25.64,74.36,110.0
669242,tommy edman,347,89,258,25.65,74.35,109.9
630105,jake cronenworth,486,125,361,25.72,74.28,109.5
678246,miguel vargas,536,138,398,25.75,74.25,109.4
660670,ronald acuña,395,102,293,25.82,74.18,108.9
663647,ke'bryan hayes,538,139,399,25.84,74.16,108.9
657757,gavin sheets,518,134,384,25.87,74.13,108.7
667670,brent rooker,664,172,492,25.9,74.1,108.5
518692,freddie freeman,601,156,445,25.96,74.04,108.2
695578,james wood,654,170,484,25.99,74.01,108.0
667472,dane myers,319,83,236,26.02,73.98,107.8
641598,mitch garver,269,70,199,26.02,73.98,107.8
542303,marcell ozuna,561,146,415,26.02,73.98,107.8
664034,ty france,476,124,352,26.05,73.95,107.6
641487,j. p. crawford,629,164,465,26.07,73.93,107.5
805300,jakob marsee,218,57,161,26.15,73.85,107.1
687263,zach neto,550,144,406,26.18,73.82,106.9
620443,luis torrens,263,69,194,26.24,73.76,106.6
649966,luis urías,327,86,241,26.3,73.7,106.3
665019,kody clemens,369,97,272,26.29,73.71,106.3
700337,edgar quero,387,102,285,26.36,73.64,106.0
545341,randal grichuk,280,74,206,26.43,73.57,105.6
669127,shea langeliers,492,130,362,26.42,73.58,105.6
694497,evan carter,219,58,161,26.48,73.52,105.3
660688,keibert ruiz,253,67,186,26.48,73.52,105.3
691016,tyler soderstrom,589,156,433,26.49,73.51,105.3
668942,josh rojas,211,56,155,26.54,73.46,105.0
680718,addison barger,486,129,357,26.54,73.46,104.9
642086,dominic smith,226,60,166,26.55,73.45,104.9
696100,hunter goodman,546,145,401,26.56,73.44,104.9
666185,dylan carlson,237,63,174,26.58,73.42,104.7
608369,corey seager,421,112,309,26.6,73.4,104.6
666176,jo adell,552,147,405,26.63,73.37,104.5
596146,max kepler,454,121,333,26.65,73.35,104.4
665833,oneil cruz,518,138,380,26.64,73.36,104.4
690993,colt keith,450,120,330,26.67,73.33,104.3
805779,jacob wilson,495,132,363,26.67,73.33,104.3
669477,casey schmitt,337,90,247,26.71,73.29,104.1
677594,julio rodríguez,674,180,494,26.71,73.29,104.1
701762,nick kurtz,471,126,345,26.75,73.25,103.8
543309,kyle higashioka,314,84,230,26.75,73.25,103.8
683146,brett baty,418,112,306,26.79,73.21,103.6
668904,royce lewis,391,105,286,26.85,73.15,103.3
665161,jeremy peña,529,142,387,26.84,73.16,103.3
668804,bryan reynolds,614,165,449,26.87,73.13,103.2
682829,elly de la cruz,658,177,481,26.9,73.1,103.1
621020,dansby swanson,601,162,439,26.96,73.04,102.8
500743,miguel rojas,289,78,211,26.99,73.01,102.6
687462,spencer horwitz,399,108,291,27.07,72.93,102.2
671739,michael harris,613,166,447,27.08,72.92,102.1
647351,abraham toro,284,77,207,27.11,72.89,101.9
681624,andy pages,586,159,427,27.13,72.87,101.8
669016,brandon marsh,398,108,290,27.14,72.86,101.8
679529,spencer torkelson,611,166,445,27.17,72.83,101.7
692225,kristian campbell,243,66,177,27.16,72.84,101.7
643217,andrew benintendi,456,124,332,27.19,72.81,101.5
663853,romy gonzalez,327,89,238,27.22,72.78,101.4
663993,nathaniel lowe,579,158,421,27.29,72.71,101.0
621493,taylor ward,640,175,465,27.34,72.66,100.8
624431,jose trevino,289,79,210,27.34,72.66,100.8
666158,gavin lux,479,131,348,27.35,72.65,100.7
802415,chandler simpson,431,118,313,27.38,72.62,100.6
656775,cedric mullins,471,129,342,27.39,72.61,100.5
672761,wenceel pérez,365,100,265,27.4,72.6,100.5
686217,sal frelick,569,156,413,27.42,72.58,100.4
650859,luis rengifo,514,141,373,27.43,72.57,100.3
680777,ryan jeffers,440,121,319,27.5,72.5,100.0
673548,seiya suzuki,602,166,436,27.57,72.43,99.6
657656,ramón laureano,486,134,352,27.57,72.43,99.6
702332,caleb durbin,499,138,361,27.66,72.34,99.2
668901,mark vientos,437,121,316,27.69,72.31,99.0
592885,christian yelich,614,170,444,27.69,72.31,99.0
666160,mickey moniak,455,126,329,27.69,72.31,99.0
682663,agustín ramírez,570,158,412,27.72,72.28,98.9
673237,yainer diaz,541,150,391,27.73,72.27,98.8
686611,dylan crews,299,83,216,27.76,72.24,98.7
677950,alek thomas,449,125,324,27.84,72.16,98.3
676059,jordan westburg,316,88,228,27.85,72.15,98.3
666971,lourdes gurriel,528,147,381,27.84,72.16,98.3
664023,ian happ,614,171,443,27.85,72.15,98.2
687363,victor scott,438,122,316,27.85,72.15,98.2
694192,jackson chourio,556,155,401,27.88,72.12,98.1
641857,ryan mcmahon,563,157,406,27.89,72.11,98.1
666969,adolis garcía,520,145,375,27.88,72.12,98.1
702616,jackson holliday,616,172,444,27.92,72.08,97.9
575929,willson contreras,544,152,392,27.94,72.06,97.8
602104,ramón urías,361,101,260,27.98,72.02,97.6
682928,cj abrams,607,170,437,28.01,71.99,97.5
664728,kyle isbel,400,112,288,28.0,72.0,97.5
805373,nacho alvarez,200,56,144,28.0,72.0,97.5
665926,andrés giménez,335,94,241,28.06,71.94,97.2
669394,jake burger,349,98,251,28.08,71.92,97.1
663586,austin riley,427,120,307,28.1,71.9,97.0
669364,xavier edwards,580,163,417,28.1,71.9,97.0
672640,otto lopez,555,156,399,28.11,71.89,97.0
687401,joey ortiz,483,136,347,28.16,71.84,96.8
691718,pete crow-armstrong,603,170,433,28.19,71.81,96.6
695336,thomas saggese,283,80,203,28.27,71.73,96.2
671732,lawrence butler,603,171,432,28.36,71.64,95.8
621438,tyrone taylor,321,91,230,28.35,71.65,95.8
666397,edouard julien,201,57,144,28.36,71.64,95.8
608348,carson kelly,401,114,287,28.43,71.57,95.5
681460,brooks baldwin,306,87,219,28.43,71.57,95.5
663743,nick fortes,225,64,161,28.44,71.56,95.4
686668,brenton doyle,506,144,362,28.46,71.54,95.3
664040,brandon lowe,530,151,379,28.49,71.51,95.2
663698,joey bart,304,87,217,28.62,71.38,94.6
606192,teoscar hernández,510,146,364,28.63,71.37,94.5
682998,corbin carroll,614,176,438,28.66,71.34,94.4
516782,starling marte,314,90,224,28.66,71.34,94.4
670242,matt wallner,383,110,273,28.72,71.28,94.1
624641,edmundo sosa,240,69,171,28.75,71.25,94.0
702284,cole young,247,71,176,28.74,71.26,94.0
664774,lamonte wade,226,65,161,28.76,71.24,93.9
660162,yoán moncada,271,78,193,28.78,71.22,93.8
624428,adam frazier,427,123,304,28.81,71.19,93.7
669707,jared triolo,354,102,252,28.81,71.19,93.7
691723,coby mayo,281,81,200,28.83,71.17,93.6
643565,mike tauchman,385,111,274,28.83,71.17,93.6
695506,jac caglianone,225,65,160,28.89,71.11,93.3
592663,j. t. realmuto,525,152,373,28.95,71.05,93.1
643376,danny jansen,321,93,228,28.97,71.03,93.0
669720,austin hays,416,121,295,29.09,70.91,92.5
700932,kyle manzardo,502,146,356,29.08,70.92,92.5
673962,josh jung,488,142,346,29.1,70.9,92.4
467793,carlos santana,460,134,326,29.13,70.87,92.3
691781,brady house,267,78,189,29.21,70.79,91.9
672820,lenyn sosa,520,152,368,29.23,70.77,91.8
670770,tj friedl,656,192,464,29.27,70.73,91.6
641584,jake fraley,205,60,145,29.27,70.73,91.6
606115,orlando arcia,201,59,142,29.35,70.65,91.3
572233,christian walker,610,179,431,29.34,70.66,91.3
691019,kyle teel,279,82,197,29.39,70.61,91.1
680776,jarren duran,663,195,468,29.41,70.59,91.0
609280,miguel andújar,306,90,216,29.41,70.59,91.0
666134,nolan jones,397,117,280,29.47,70.53,90.8
660821,jesús sánchez,485,143,342,29.48,70.52,90.7
673357,luis robert,413,122,291,29.54,70.46,90.5
683011,anthony volpe,569,168,401,29.53,70.47,90.5
665966,carlos narváez,436,129,307,29.59,70.41,90.2
624424,michael conforto,452,134,318,29.65,70.35,90.0
687597,jordan beck,560,166,394,29.64,70.36,90.0
682622,noelvi marte,344,102,242,29.65,70.35,90.0
691176,jasson domínguez,418,124,294,29.67,70.33,89.9
694374,tim tawa,212,63,149,29.72,70.28,89.7
669065,kyle stowers,441,131,310,29.71,70.29,89.7
664983,jake mccarthy,202,60,142,29.7,70.3,89.7
678662,ezequiel tovar,358,107,251,29.89,70.11,89.0
669911,michael toglia,321,96,225,29.91,70.09,88.9
592206,nick castellanos,561,168,393,29.95,70.05,88.7
571771,enrique hernández,226,68,158,30.09,69.91,88.1
663624,ryan mountcastle,332,100,232,30.12,69.88,88.0
643289,mauricio dubón,375,113,262,30.13,69.87,87.9
678554,curtis mead,255,77,178,30.2,69.8,87.7
514888,josé altuve,626,189,437,30.19,69.81,87.7
691026,masyn winn,522,158,364,30.27,69.73,87.4
643396,isiah kiner-falefa,439,133,306,30.3,69.7,87.2
642133,rowdy tellez,297,90,207,30.3,69.7,87.2
527038,wilmer flores,445,135,310,30.34,69.66,87.1
656976,pavin smith,279,85,194,30.47,69.53,86.6
670764,taylor walls,308,94,214,30.52,69.48,86.3
669224,austin wells,426,130,296,30.52,69.48,86.3
681393,connor norby,323,99,224,30.65,69.35,85.8
666181,will benson,248,76,172,30.65,69.35,85.8
682177,daniel schneemann,407,125,282,30.71,69.29,85.6
545361,mike trout,524,161,363,30.73,69.27,85.5
521692,salvador pérez,602,185,417,30.73,69.27,85.5
680574,matt mclain,547,168,379,30.71,69.29,85.5
682657,angel martínez,472,145,327,30.72,69.28,85.5
553993,eugenio suárez,627,193,434,30.78,69.22,85.3
656180,riley adams,279,86,193,30.82,69.18,85.1
664056,harrison bader,480,148,332,30.83,69.17,85.1
668709,jj bleday,314,97,217,30.89,69.11,84.8
807713,matt shaw,398,123,275,30.9,69.1,84.8
678882,ceddanne rafaela,559,174,385,31.13,68.87,83.9
641680,jonah heim,416,130,286,31.25,68.75,83.4
701538,jackson merrill,450,141,309,31.33,68.67,83.1
686681,michael massey,248,78,170,31.45,68.55,82.6
666624,christopher morel,285,90,195,31.58,68.42,82.2
642201,eli white,269,85,184,31.6,68.4,82.1
596115,trevor story,626,198,428,31.63,68.37,82.0
681351,logan o'hoppe,427,135,292,31.62,68.38,82.0
677587,brayan rocchio,357,113,244,31.65,68.35,81.9
668715,spencer steer,540,171,369,31.67,68.33,81.8
810938,ben williamson,295,94,201,31.86,68.14,81.1
553869,elías díaz,270,86,184,31.85,68.15,81.1
677942,blaze alexander,257,82,175,31.91,68.09,80.9
681297,colton cowser,326,104,222,31.9,68.1,80.9
676609,josé caballero,356,114,242,32.02,67.98,80.5
677800,wilyer abreu,387,124,263,32.04,67.96,80.4
572191,michael taylor,308,99,209,32.14,67.86,80.1
691023,jordan walker,372,120,252,32.26,67.74,79.6
672275,patrick bailey,434,141,293,32.49,67.51,78.8
693307,dillon dingler,446,145,301,32.51,67.49,78.7
669221,sean murphy,336,111,225,33.04,66.96,76.9
656716,zach mckinstry,490,162,328,33.06,66.94,76.8
571657,kyle farmer,288,96,192,33.33,66.67,75.8
670224,kameron misner,207,69,138,33.33,66.67,75.8
701358,cam smith,474,158,316,33.33,66.67,75.8
663886,tyler stephenson,332,111,221,33.43,66.57,75.5
805249,otto kemp,215,72,143,33.49,66.51,75.3
595879,javier báez,412,138,274,33.5,66.5,75.3
695657,colson montgomery,265,89,176,33.58,66.42,75.0
666139,josh lowe,425,144,281,33.88,66.12,74.0
650489,willi castro,435,148,287,34.02,65.98,73.5
682985,riley greene,624,213,411,34.13,65.87,73.2
680779,henry davis,275,94,181,34.18,65.82,73.0
669397,nick allen,409,140,269,34.23,65.77,72.9
624585,jorge soler,299,103,196,34.45,65.55,72.2
669357,nolan gorman,385,133,252,34.55,65.45,71.9
672744,alexander canario,227,79,148,34.8,65.2,71.0
700242,trey sweeney,308,108,200,35.06,64.94,70.2
690987,robert hassell,202,71,131,35.15,64.85,70.0
519317,giancarlo stanton,264,93,171,35.23,64.77,69.7
672356,gabriel arias,444,157,287,35.36,64.64,69.3
662139,daulton varsho,254,90,164,35.43,64.57,69.1
672724,oswald peraza,259,92,167,35.52,64.48,68.8
671221,drew waters,219,78,141,35.62,64.38,68.6
664238,dylan moore,230,83,147,36.09,63.91,67.2
686780,pedro pagés,378,139,239,36.77,63.23,65.2
666149,tyler fitzgerald,229,86,143,37.55,62.45,63.1
518595,travis d'arnaud,227,86,141,37.89,62.11,62.2
